T________________T
__________________
____C________C____
_K________________
R_______RR_______R
R_______RR_______R
__________________
____B________R____
__________________
T________________T
