T_______T________T
__________________
____C____C___T____
__________________
__________________
R_______R_________
__________________
____B________R____
__________________
T_________________
